M M M M M M M M M . . M M M M M M M M M . . . . . . . . . . . M M M M M M M M M . . M M M M M M M M M
M M M M M M M M M . . M M M M M M M M M . . . . . . . . . . . M M M M M M M M M . . M M M M M M M M M
M . . . . . . . . . . . . . . . . . . . . . . . W W . . . . . . . . . . . . . . . . . . . . . . . . M
M . . . . . . . . . . . . M M M M M . . . . . . W P . . . . . . . M M M M M . . . . . . . . . . . . M
M . . . . . . . . . . . . M . . . M . . . . . . W W . . . . . . . M . . . M . . . . . . . . . . . . M
M . . . . . . . . . . . . M . . . M . . . . . . W W . . . . . . . M . . . M . . . . . . . . . . . . M
M . . . . . . . . . . . . M M M . M . . . . . . W W . . . . . . . M . M M M . . . . . . . . . . . . M
M . T . . . T . . . P . . . . . . . . . . . P . . . . . P . . . . . . . . . . . P . . . T . . . T . M
. . . . T . . . . . . . . . . . . . . . . . . . W W . . . . . . . . . . . . . . . . . . . . T . . . .
. . . T . T . T . . . . . . . . . . . . . . . . W W . . . . . . . . . . . . . . . . . T . T . T . . .
. . . . T . T . . . . . . . . . . . . . . . . . W W . . . . . . . . . . . . . . . . . . T . T . . . .
. . . . . T . . . . . . . . . . . . . . . . . . W W . . . . . . . . . . . . . . . . . . . T . . . . .
. . . T . . . . . . . . . . . . . . . . . . . . W W . . . . . . . . . . . . . . . . . . . . . T . . .
. . . . . . . . . . R R . . . . . . . . . . . . W W . . . . . . . . . . . . . R R . . . . . . . . . .
. . . . . . . . . . . . . . . . . . . . . . . . W W . . . . . . . . . . . . . . . . . . . . . . . . .
. . . . . . . . . . . . . . . . . . . . . . P . . . . . P . . . . . . . . . . . . . . . . . . . . . .
. . . . . . . . . . . . . . . . . . . . . . . . W W . . . . . . . . . . . . . . . . . . . . . . . . .
. . T . . . . . . . . . . . . . . . . . . . . . W W . . . . . . . . . . . . . . . . . . . . . . T . .
. . . T . T . . . . . . . . . . . . . . . R . . W W . . . R . . . . . . . . . . . . . . . T . T . . .
. . . . T . . T . . . . . . . . . . . . . . . . W W . . . . . . . . . . . . . . . . . T . . T . . . .
. . . . . . T . T . . . . . . . . . . . . . . . W W . . . . . . . . . . . . . . . . T . T . . . . . .
. . . . T . . . . . . . . . . . . . . . . . . . W W . . . . . . . . . . . . . . . . . . . . T . . . .
. . . . . . . . . . . . . . . . . . R . . . . . W W . . . . . . R . . . . . . . . . . . . . . . . . .
M . . . . . . . . . . . . . . . . . . . . . P . . . . . P . . . . . . . . . . . . . . . . . . . . . M
M . . . . . . . . . . . . . . . . . . . . . . . W W . . . . . . . . . . . . . . . . . . . . . . . . M
M . . . . . . . . . R R R . . . . . M M M . . . W W . . . . M M M . . . . . R R R . . . . . . . . . M
M . . . . . . . . . . R . . . . . . M . . . . . W W . . . . . . M . . . . . . R . . . . . . . . . . M
M . . . . . . . . . . . . P . . . . M . . . . . W P . . . . . . M . . . . P . . . . . . . . . . . . M
M . . . . . . . . . . . . . . . . . . . . . . . W W . . . . . . . . . . . . . . . . . . . . . . . . M
M M M M M M M M M . . M M M M M M M M M . . . . . . . . . . . M M M M M M M M M . . M M M M M M M M M
M M M M M M M M M . . M M M M M M M M M . . . . . . . . . . . M M M M M M M M M . . M M M M M M M M M
