- - - - - - - - - -
| T . T . W . . . |
| . T . . W . T . |
| . . . . M . . . |
| R . . . . T . . |
| . P . . . T . . |
| . . T . . . . . |
| . M . . R . . . |
| T . . . . M . . |
- - - - - - - - - -