| . . T . . . . . .
| . . . . . . W . .
| . . . . . T . . .
| . . . . . . . . . 
| . . . . M . . . .
| . T . | - | . . .
| . . P . . | T . .
| . . . . . . . . .
| . . . M . . . . .
| - - - - - - - - - 