. . . T . . . . . . 
. . . . . . . . . . 
. . . . . . T . . . 
. . . . . . . . . . 
. . . . . . . . . . 
. . T . . . . . . . 
. . . . . . . T . . 
. . . . . . . . . . 